#format => word: [transcription] description
abort: [əˈbɔː(r)t] Прекратяване на нещо
abroad: [əˈbrɑːd] Място в чужбина
accomplish: [əˈkʌmplɪʃ] постигам, завършвам, осъществявам
ambition: [æmˈbɪʃn] амбиция
ambush: [ˈæmbʊʃ] дебна, причаквам нкг
banana: [bəˈnɑː.nə] Високо тропическо растение с много големи листа и дебелокожи, сладки и меки продълговати плодове
base: [beɪs] долна част, подножие, дъно, основа, фундамент, база, основна съставна част
beset: [bɪˈset] затормозвам, спъвам, обхванат
belittle: [bɪˈlɪtl, Am -ˈlɪt̬-] омаловажавам, 
bellow: [ˈbeləʊ, Am -oʊ] крещя, муча, силен вик, вой
cavalry: [ˈkævlrɪ] кавалерия
chalk: [tʃɔːk] варовик, креда, тебешир
challenge: [ˈtʃælɪndʒ] покана за състезание, предизвикателство, оспорване, възражение, отвод, предизвиквам
cheeky: [ˈtʃiːkɪ] нахален, нагъл
conquer [ˈkɒŋkəʳ] завземам, превземам, преодолявам, разрешавам
deck: [dek] палуба, колода, етаж на бус
deadline: [ˈdedlaɪn] краен срок
delighted: [dɪˈlaɪtɪd] очарован, възхитен, наслада, радвам
drum: [drʌm] барабан, варел, бидон, тъпанче
delicacy: [ˈdelɪkəsɪ] деликатност, вежливост, деликатес
enact: [ɪˈnækt] извършвам, осъществявам, играя, разигравам, постановявам, издавам
enquire: [ɪnˈkwaɪəʳ] запитвам, поисквам да знам
extricate: [ˈekstrɪkeɪt] освобождавам, избавям
expand: [ɪkˈspænd] уголемявам, уголемявам се, разширявам се
extermination: [ɪkˌstɜːmɪˈneɪʃn] унищожение, изтребление
fable: [ˈfeɪbl] басня, измислица
fount: [faʊnt] извор, източник
friction: [ˈfrɪkʃn] търкане, триене, несъгласие, търкане
fragment: [ˈfrægmənt] парче, къс 
fiction: [ˈfɪkʃn] измислица, фикция, художествена проза, белетристика, лъжа
grace: [greɪs] грация, елегантност, милост, благоволение, благоприличие, отсрочка
gadget: [ˈgædʒɪt] приспособление, дребен предмет, приспособления, джаджи
gust: [gʌst] порив, изблик, бликвам
genuine: [ˈdʒenjʊɪn] истински, искрен
greed: [griːd] алчност, лакомия
home: [həʊm] дом
habitat: [ˈhæbɪtæt] хабитат, естествена среда
hidden: [ˈhɪdn] скрит, прикрит
hoard: [hɔːd] запас, складирам, запасявам се с
herb: [hɜːb] билка
importance: [ɪmˈpɔːtns] важност, значение
imply: [ɪmˈplaɪ] намеквам, загатвам, предполагам, означавам
impart: [ɪmˈpɑːt] придавам, предавам, съобщавам, придавам, споделям, разкривам
inability: [ˌɪnəˈbɪlətɪ] неспособност
inventor: [ɪnˈventəʳ] изобретател
joy: [dʒɔɪ] радост, удоволствие
jacket: [ˈdʒækɪt] сако, обложка, обвивка
jackdaw: [ˈdʒækdɔː] гарга
judge: [dʒʌdʒ] съдия, преценявам, рефер, съдя, решавам
jubilee: [ˈdʒuːbɪliː] празненство
kleptomania: [ˌkleptəˈmeɪnɪə] клептомания 
kindle: [ˈkɪndl] запалвам, въодушевявам, разпалвам
keen: [kiːn] остър, силен, интензивен, ожесточен
kinship: [ˈkɪnʃɪp] родство, близост
kilt: [kɪlt] шотландска поличка
leader: [ˈliːdəʳ] водач, ръководител, диригент
lecturer: [ˈlektʃərəʳ] лектор, преподавател
legion: [ˈliːdʒən] легион, множество
lease: [liːs] наем, лизинг, наемно споразумение, договор, наемен срок
linden: [ˈlɪndən] липа
magnificent: [mægˈnɪfɪsnt] величествен, разкошен
magpie: [ˈmægpaɪ] сврака
magnetize: [ˈmægnɪtaɪz] очаровам, привличам
malignant: [məˈlɪgnənt] злокачествен, вреден
mystification: [ˌmɪstɪfɪˈkeɪʃn] тайна, мистерия, заблуда 
net: [net] мрежа, тюл 
nevertheless: [ˌnevəðəˈles] въпреки това, въпреки всичко
neutral; [ˈnjuːtrəl] неутрален, безпристрастен, сдържан
noble: [ˈnəʊbl] аристократичен, възвишен, благородник
nimble: [ˈnɪmbl] пъргав, сръчен, схватлив
outbid: [ˌaʊtˈbɪd] предлагам по-висока цена, наддавам
outrun: [ˌaʊtˈrʌn] надбягвам, избягвам, преминавам границите на
overboard: [ˈəʊvəbɔːd] извън борда, падам през борда
own: [əʊn] собствен, притежавам
overrun: [ˌəʊvəˈrʌn] опустошаване, надвишаване, гъмжа, превишавам
penalty: [ˈpenltɪ] наказание, вреда, санкция, глоба
peep: [piːp] звук, дума, надничане, надзъртане
pawn: [pɔːn] пионка, залог
pester: [ˈpestəʳ] тормозя, досаждам
petrify: [ˈpetrɪfaɪ] вкаменявам се, вцепенявам се, вкаменявам
quick: [kwɪk] бърз, бързо
quiet: [ˈkwaɪət] тишина, безшумен, тих
quirk: [kwɜːk] чудатост, странно съвпадение
quench: [kwentʃ]утолявам нечия жажда, гася, потискам
quick-witted: [ˌkwɪkˈwɪtɪd] схватлив, съобразителен
reason: [ˈriːzn] причина, разум, разсъдък
ransom: [ˈrænsəm] откуп
recovery: [rɪˈkʌvərɪ] възстановяване, оживление, 
revel: [ˈrevl] гуляя, пирувам, наслаждавам се
reveal: [rɪˈviːl] разкривам, откривам, разбулвам
sabotage: [ˈsæbətɑːʒ] саботирам, саботаж
secret: [ˈsiːkrɪt] тайна, майсторство, загадка, таен
scrutiny: [ˈskruːtɪnɪ] преглеждане
severity: [sɪˈverətɪ] тежко заболяване, суровост, строгост
savagery: [ˈsævɪdʒrɪ] варварство
track: [træk] пътечка, писта, релси, следа, път 
trunk: [trʌŋk] стъбло, ствол, хобот, багажник
turnip: [ˈtɜːnɪp] ряпа
trickery: [ˈtrɪkərɪ] измама, хитрина
trap: [træp] капан, сифон, уста
unity: [ˈjuːnətɪ] единство, съгласие
unabated: [ˌʌnəˈbeɪtɪd] нестихващ, неотслабващ
unaltered: [ˌʌnˈɔːltəd] непроменен
umpire: [ˈʌmpaɪəʳ] арбитър, рефер
untie: [ˌʌnˈtaɪ] развързвам, отвързвам
vanguard: [ˈvængɑːd] авангард
vanity: [ˈvænətɪ] суета
voracious: [vəˈreɪʃəs] лаком, изгладнял, ненаситен читател
victorious: [vɪkˈtɔːrɪəs] победител
valuator: [ˈvæljʊeɪtəʳ] оценител
wacky: [ˈwækɪ] чалнат, мръднал
weaken: [ˈwiːkən] отслабвам, омеквам, разреждам
wicked: [ˈwɪkɪd] зъл, лош, нечестив, злонамерен, лукав
watchful: [ˈwɒtʃfl] внимателен, бдително наблюдавам
weapon: [ˈwepən] оръжие, средство
xenophobic: [ˌzenəˈfəʊbɪk] ксенофобен
xerox: [ˈzɪərɒks] фотокопие
Xmas: [ˈeksməs] Коледа
X-ray: [] рентгенови лъчи, рентгенов преглед, рентгенова снимка
xylophone: [ˈzaɪləfəʊn] ксилофон
yearn: [jɜːn] изгарям от желание да направя нщ, копнея за
yap: [jæp] дърдоря, плещя, дърдорене
yard: [jɑːd] двор, склад, градина
yell: [jel] вик, изревавам
yield: [jiːld] продукция, печалба, добив, поддавам, огъвам се, отстъпвам
zip: [zɪp] цип, затварям
zeal: [ziːl] усърдие
zenith: [ˈzenɪθ] зенит
zone: [zəʊn] зона 
zoology: [zəʊˈɒlədʒɪ] зоология
